og=nazzing
oh=Bizarro Sephiroth
oi=Grassland
oj=Mt. Nibel
ok=Forest
ol=Shoreline
om=Desert or Mt. Corel
on=Arctic
oo=Swamp
op=Sector 1 (Train)?
oq=Reactor
or=Reactor (Guard Scorpion)
os=Reactor 1 Enterance
ot=Subway
ou=Mythril Caves?
ov=ShinRa HQ
ow=Subway
ox=Hojo's Lab
oy=Elevators
oz=Roof
pa=Highway
pb=Don Corneo's
pc=Cathedrel
pd=Ancient Forest?
pe=Midgar Slums
pf=Reactor 1
pg=Reactor
ph=Sector 7 Pillar Stairs
pi=Sector 7 Pillar Control
pj=Sector 8
pk=Sewers
pl=Cave
pm=Cave
pn=Corel passage?
po=Junon Beach
pp=ShinRa Freighter
pq=Corel
pr=Battle Square
ps=Da Chao
pt=Cid's
pu=Lifestream Descent.
pv=Reactor 5 Enterance
pw=Ancient Temple
px=ShinRa Mansion
py=Junon Aerodrome
pz=Cave
qa=Under Sector 8
qb=Gongaga Reactor
qc=Gelnika
qd=Train Graveyard
qe=Ice Cave
qf=Sister Ray?
qg=Sector 8?
qh=Cetra Altar
qi=Cave
qj=Spire in the Crater
qk=Crater (Jungle)
ql=Sephiroth's Vortex
qm=Midgar Area
qn=Seafloor Tunnels
qo=Blank.
qp=Corel Railways
qq=The Crater
qr=Corel Railway Bridge
qs=Rope Bridge
qt=Da Chao
qu=Ft Condor
qv=Midgar Area
qw=Bizzarro Seph R/L
qx=Bizzarro Seph L/R
qy=Jenova SYNTHESIS
qz=Coal Trains
ra=Cosmo Canyon
rb=Gi Cave
rc=Nibelheim Basement
rd=Cetra Temple
re=Cetra Temple (dragon)
rf=Cetra Temple
rg=Final Battle
rh=Forest
ri=Highwind
rj=Corel Reactor
rk=Blank
rl=Wutai Temple
rm=Seafloor
rn=Reactor?
ro=Bloody ShinRa HQ
rp=Gongaga Reactor
rq=Corel Prison
rr=Forest